*************************
*                       *
*                       *
*                       *
*                       *
*                       *
*                       *
*                       *
*                       *
*                       *
*                       *
*                       *
*                       *
*                       *
*                       *
*                       *
*                       *
*                       *
*                       *
*                       *
*                       *
*                       *
*                       *
*                       *
***********+*************
